Level 42
    #####   #####
    #   #   #   #
  ###   #####   ###
  # .$.$. #  $.$  #
### $.$.$ #.$.$.$.###
#  $.$.$.$ $.$.$.$  #
#  .$.$.$. .$.$.$.  #
#  $.$.$.$ $.$.$.$  #
### $.$.$ #.$.$.$.###
  # .$.$. .  $.$  #
  ###   #.@.#   ###
  #  $.$  . .$.$. #
###.$.$.$.# $.$.$ ###
#  $.$.$.$ $.$.$.$  #
#  .$.$.$. .$.$.$.  #
#  $.$.$.$ $.$.$.$  #
###.$.$.$.# $.$.$ ###
  #  $.$  # .$.$. #
  ###   #####   ###
    #   #   #   #
    #####   #####