Level 43
         #####
        ##   ##
       ##.$.$.##
       ##$.$.$##
       # .$.$. #
       # $.$.$ #
       # .$.$. #
  ###### $.$.$ ######
 ###     .$.$.     ###
##.$.$.$.$.$.$.$.$.$.##
# $.$.$.$.$ $.$.$.$.$ #
# .$.$.$.$ @ $.$.$.$. #
# $.$.$.$.$ $.$.$.$.$ #
##.$.$.$.$.$.$.$.$.$.##
 ###     .$.$.     ###
  ###### $.$.$ ######
       # .$.$. #
       # $.$.$ #
       # .$.$. #
       ##$.$.$##
       ##.$.$.##
        ##   ##
         #####