Level 48
 ##########################  #
##                        ##
# *.*.* *.*.* *.*.* *.*.* ###
# .$ $.$.$ $.$.$ $.$.$ $. .###
# * $ * * $ * * $ * * $ *#   #
# .$ $.*.$ $.*.$ $.*.$ $.*.* #
# *.*.$ $.*.$ $.*.$ $.*.$ $. #
#  $ * $ * * $ * * $ * * $ * #
# *.*.$ $.*.$ $.*.$ $.*.$ $. #
# .$ $.*.$ $.*+$ $.*.$ $.*.* #
# * $ * * $ * * $ * * $ * $  #
# .$ $.*.$ $.*.$ $.*.$ $.*.* #
# *.*.$ $.*.$ $.*.$ $.*.$ $. #
#   #* $ * * $ * * $ * * $ * #
###. .$ $.$.$ $.$.$ $.$.$ $. #
 ### *.*.* *.*.* *.*.* *.*.* #
  ##                        ##
#  ##########################